FFFFFFFFFFFFFFFFFFF
0000000000000000000
0000000000000000000
0000000000000000000
0000000000000000000
0000000000000000000
0000000000000000000
0000000000000WWW000
0000000000000WPW000
0000WWWWWWWWWWFWWW0
0WWWWKFFFFFFFFFFFW0
0WEFHFFFFMFFFFFFFW0
0WWWFFFFFFFFFFFFFW0
000WWWWWWWWWWWWWWW0
0000000000000000000
0000000000000000000
FFFFFFFFFFFFFFFFFFF