FFFFFFFFFFFFFFFFFFF
WWWWWWWWWWWWWWWWWWW
WFFIFFFWWFFFFWFFFFW
WFWFFFFFFFFFFFIFFFW
WFFFWWFFFFWWWFFWWWW
WWWFWWWFFFWWWFFFFPW
WWFFWWWFWFWWKFTFFWW
WWFFFFFIFIFFFFFFFWW
WWWFFFWFWFWFFFFFFFW
WWWFFIFIFIFFFFFFFFW
WFFFFMWFWFWWWWWWWWW
WFFIFFFIFIFFWFFFHIW
WFFFWFFIFIFFWWWEWIW
WFFFFFFFWFFFFIWWWIW
WFFWFFFFWBWFFIIIIIW
WWWWWWWWWWWWWWWWWWW
FFFFFFFFFFFFFFFFFFF