FFFFFFFFFFFFFFFFFFF
0000000000000000000
0WWWWW000000WWWWW00
0WFFFWWWWWWWWFFFW00
0WFFFWWFFFFWWFFFW00
0WWFFFFFFFFFFFFWW00
00WFWWWWFFWWWWHW000
00WFW0WFFFFW0WFW000
00WPW0WMFFKW0WEW000
00WWW0WWWWWW0WWW000
0000000000000000000
0000000000000000000
0000000000000000000
0000000000000000000
0000000000000000000
0000000000000000000
FFFFFFFFFFFFFFFFFFF