FFFFFFFFFFFFFFFFFFF
00WWWWWWWWWWWWWWWW0
0WWFFFFFFFFFFFFFFW0
0WFFWWWWIIFFFFIFFW0
0WFFFIMFFFFFFFIFFW0
0WWWFIWWWHWWWWFWWW0
000WFIWWWEWFKWFW000
0WWWFIWWWWWFFWFW000
0WFFFFFWWWWFFWPW000
0WFWWWFFFFFFFWWW000
0WFWWWFFFFFWFW00000
0WFFFFFWWWFFFW00000
0WWWWWWW0WWWWW00000
0000000000000000000
0000000000000000000
0000000000000000000
FFFFFFFFFFFFFFFFFFF