FFFFFFFFFFFFFFFFFFF
0000000000000000000
0000000000000000000
0000000000000000000
0000000000000000000
0000000000000000000
0000000000000000000
0000000000000WWW000
000000WWWWW00WEW000
000WWWWFFKWWWWFWWW0
0WWWFFFFFFFFFWFFFW0
0WPFFFFFFFFFFWFFFW0
0WWWWFFFWFMFFHFFFW0
0000WWWWWWWWWWWWWW0
0000000000000000000
0000000000000000000
FFFFFFFFFFFFFFFFFFF